28 16
0 0 0 0 0 0 0 0 0 0 0 0 0 0 0 0 0 0 6 0 0 0 0 0 0 0 0 0 
0 3 1 1 0 0 0 0 0 0 0 0 0 0 0 0 0 0 6 0 0 0 0 0 0 0 0 0 
0 3 0 0 0 0 0 0 0 0 1 1 1 1 0 0 0 0 6 0 0 0 0 0 0 0 0 0 
0 3 0 0 0 0 0 0 0 0 0 0 0 0 0 0 0 0 6 0 0 0 0 0 0 0 0 0 
0 3 0 0 0 0 0 0 0 0 0 0 0 0 0 0 0 0 6 0 0 0 0 0 0 0 0 0 
0 3 0 0 0 0 0 0 0 0 0 0 0 0 0 0 0 0 6 0 0 0 1 1 1 0 0 0 
0 3 0 0 0 4 4 4 4 7 0 0 0 0 0 0 0 0 6 0 0 0 0 0 0 0 0 0 
0 3 0 0 1 0 0 0 0 1 1 0 0 0 0 0 0 0 6 0 0 0 0 0 0 0 0 0 
0 3 0 0 0 0 0 0 0 0 0 0 0 0 0 0 0 0 6 0 0 0 0 0 0 0 0 0 
0 3 0 0 0 0 0 0 0 0 0 0 0 0 0 0 0 1 6 0 0 0 0 0 0 0 0 0 
0 3 0 0 0 0 0 0 0 1 1 1 1 1 1 1 1 1 6 1 0 0 0 8 0 0 0 0 
0 3 0 0 0 0 0 0 0 0 0 0 1 0 0 0 0 0 6 0 0 0 1 0 0 1 0 0 
0 3 0 0 0 0 0 0 0 0 0 0 1 0 0 0 0 0 6 0 0 0 1 1 1 1 0 0 
0 3 0 0 0 0 0 0 0 0 0 0 1 0 0 0 0 0 6 0 0 0 0 0 0 0 0 0 
0 3 0 0 0 0 7 0 0 0 0 9 1 0 0 0 0 0 6 0 0 0 0 0 0 0 0 0 
1 1 1 1 1 1 1 1 1 1 1 1 1 1 1 1 1 1 1 1 1 1 1 1 1 1 1 1 
