28 16
0 0 0 0 0 0 6 0 0 0 0 0 0 0 0 0 0 0 0 0 0 0 0 0 0 0 0 6 
0 0 0 0 0 0 6 0 0 0 0 0 0 8 0 0 0 0 0 0 0 0 0 0 0 0 0 6 
4 4 4 0 8 0 6 4 4 4 4 4 4 1 1 1 1 1 3 0 0 0 0 8 0 0 0 6 
3 1 1 2 1 1 1 0 1 1 1 1 1 1 1 3 7 1 1 1 1 1 1 1 1 1 1 3 
3 1 1 7 1 1 1 0 2 7 0 0 0 3 1 3 1 1 0 0 0 7 0 0 0 7 0 3 
3 1 1 1 1 1 1 0 2 2 2 2 2 3 2 3 0 0 0 4 4 4 4 4 4 4 0 3 
3 0 0 0 0 0 0 0 0 4 4 4 4 3 0 3 0 0 0 3 0 0 0 0 0 0 0 3 
1 1 5 1 1 1 3 0 0 0 0 0 0 0 0 3 0 0 0 3 0 0 1 0 0 0 0 3 
4 4 4 0 0 0 3 1 1 1 1 1 1 0 1 1 1 1 1 1 1 3 1 1 1 1 1 1 
7 0 0 0 3 1 1 0 0 0 0 0 4 4 4 4 1 0 3 3 3 3 3 3 3 3 4 4 
0 0 0 0 3 1 0 0 2 2 2 3 0 0 0 0 1 7 3 3 3 3 3 3 3 3 0 7 
3 1 1 1 1 0 0 1 0 0 0 2 2 2 3 0 1 4 3 3 3 3 3 3 3 3 0 4 
3 0 0 0 0 0 1 0 0 3 1 1 1 1 3 0 1 7 3 3 3 3 3 3 3 3 0 0 
3 0 0 0 3 1 0 0 0 3 1 1 1 1 3 0 1 4 3 3 3 3 3 3 3 3 0 0 
3 9 0 0 3 1 3 0 0 3 1 0 7 1 3 0 1 1 1 1 1 1 1 1 1 1 1 3 
1 1 1 1 1 1 1 1 1 1 1 1 1 1 1 0 0 0 0 0 0 0 0 0 0 0 0 3 
