28 16
0 0 0 0 0 0 0 0 0 0 0 0 0 0 6 0 0 0 0 0 0 0 0 0 0 0 0 0 
0 0 0 4 4 4 4 4 4 4 4 0 0 4 6 4 4 4 0 0 0 0 0 0 0 0 0 0 
0 0 3 0 0 0 0 0 0 0 0 3 4 0 0 0 0 0 3 0 3 1 1 1 1 3 0 0 
0 0 3 4 4 4 4 4 4 4 8 3 4 4 4 4 4 4 0 3 1 0 3 4 0 1 3 0 
0 0 3 0 0 0 0 0 0 0 3 1 0 0 4 4 4 0 3 1 0 0 3 0 7 0 5 3 
0 0 3 0 0 0 0 0 0 3 5 0 1 3 0 0 0 3 1 0 0 0 3 0 0 0 7 1 
0 0 3 0 0 4 4 0 3 1 0 0 0 1 3 0 4 0 9 4 4 4 3 4 4 4 4 1 
3 0 1 3 3 6 0 3 1 7 3 1 1 0 1 3 0 0 1 0 0 0 0 0 0 0 0 1 
3 1 0 1 3 6 0 3 1 1 1 1 1 1 1 3 0 0 1 1 1 1 0 1 1 1 1 1 
1 1 5 1 1 6 0 3 1 0 0 1 7 0 1 3 4 3 0 0 0 0 4 0 0 0 8 3 
1 1 5 1 1 6 0 3 1 1 1 1 1 1 1 0 0 3 1 1 1 1 0 1 1 1 1 3 
1 0 7 0 1 6 0 3 1 0 7 1 0 0 1 3 0 3 1 7 1 1 0 1 1 1 1 3 
1 1 1 1 1 6 0 3 1 1 1 1 1 1 1 3 0 3 1 1 1 1 0 1 1 7 1 3 
1 1 1 1 1 6 0 3 1 0 0 1 7 0 0 3 0 3 1 0 0 0 0 1 0 0 0 3 
1 0 0 0 1 6 0 3 1 1 1 1 1 1 1 3 0 3 1 1 5 1 1 1 5 1 1 3 
1 0 7 0 0 6 1 3 0 0 0 0 0 0 1 3 1 3 0 0 0 1 0 0 7 0 0 3 
