28 16
0 0 0 0 0 0 2 4 4 4 4 4 4 4 0 0 4 4 4 0 3 3 1 1 3 0 0 6 
7 0 0 0 8 7 2 4 4 4 4 4 4 7 1 1 0 0 0 3 3 1 1 3 3 0 0 6 
1 1 1 3 1 1 2 0 0 0 0 0 7 1 1 0 0 0 3 3 1 1 3 3 7 0 0 6 
0 0 0 3 0 0 2 0 0 0 0 7 1 1 0 0 0 3 3 1 1 3 3 7 0 2 2 6 
7 0 0 3 0 7 2 0 0 0 7 1 1 0 0 0 3 3 1 1 3 3 7 0 2 2 0 6 
1 1 1 3 1 1 2 0 0 7 1 1 0 0 0 3 3 1 1 3 3 7 0 2 2 0 0 6 
0 0 9 3 0 0 2 0 7 1 1 0 0 0 3 3 1 1 3 3 7 0 2 2 0 7 7 6 
1 1 1 3 0 7 2 7 1 1 0 0 0 3 3 1 1 3 3 7 0 2 2 0 3 1 1 0 
1 1 1 3 1 1 2 1 1 0 0 0 3 3 1 1 3 3 7 0 2 2 0 0 3 7 7 0 
1 7 1 3 0 0 2 0 7 0 0 3 3 8 0 3 3 7 0 2 2 0 3 1 1 1 1 0 
1 1 1 3 0 7 2 1 1 1 1 1 1 1 1 1 1 1 3 2 0 0 3 7 0 8 7 0 
7 1 1 3 1 1 2 4 4 4 4 4 4 4 4 4 4 4 3 2 0 3 1 1 1 1 1 0 
1 1 1 3 0 7 2 7 0 7 0 0 3 0 0 0 0 0 0 2 0 3 7 0 0 0 7 0 
1 2 2 2 2 2 2 1 1 1 0 0 3 0 1 1 1 1 0 2 0 3 1 1 1 1 1 0 
0 0 0 0 0 0 0 0 0 0 0 8 3 1 1 7 7 1 1 2 0 3 7 0 0 0 7 0 
1 1 1 1 1 1 1 1 1 1 1 1 2 1 1 1 1 1 1 2 0 1 1 1 1 1 1 1 
