28 16
0 0 0 0 0 0 0 4 4 0 0 0 0 0 0 0 0 0 0 4 4 0 0 0 0 4 4 0 
0 1 1 1 1 1 1 7 4 3 1 1 1 1 1 1 1 1 3 4 7 1 1 1 1 7 4 0 
0 1 1 1 1 1 1 1 7 3 1 1 1 1 1 1 1 1 3 7 1 1 1 1 1 1 7 0 
0 1 1 1 1 1 1 1 1 3 1 1 1 1 1 1 1 1 3 1 1 1 1 1 1 1 1 0 
0 1 1 1 0 1 1 1 1 3 1 1 1 0 0 0 0 0 3 1 1 1 0 0 0 1 1 0 
0 1 1 1 0 0 1 1 1 3 1 1 1 7 7 7 0 0 3 1 1 1 7 7 7 4 4 0 
0 1 1 1 0 0 1 1 1 3 1 1 1 1 1 1 0 0 3 1 1 1 1 1 1 7 4 0 
0 1 1 1 0 0 1 1 1 3 1 1 1 1 1 1 0 0 3 0 1 1 1 1 1 1 7 0 
0 1 1 1 0 0 1 1 1 3 1 1 1 1 1 1 0 0 3 0 0 1 1 1 1 1 1 0 
0 1 1 1 0 7 1 1 1 3 1 1 1 0 0 0 0 0 3 0 0 0 0 0 1 1 1 0 
0 1 1 1 7 1 1 1 1 3 1 1 1 7 7 7 7 7 3 1 1 7 7 7 1 1 1 0 
0 1 1 1 1 1 1 1 1 3 1 1 1 1 1 1 1 1 3 1 1 5 1 1 1 1 1 0 
0 1 1 1 1 1 1 1 0 3 1 1 1 1 1 1 1 1 3 0 1 5 1 1 1 1 0 0 
0 1 1 1 1 1 1 0 0 3 1 1 1 1 1 1 1 1 3 0 0 5 1 1 1 0 0 0 
0 0 8 0 0 8 0 0 0 3 0 0 0 9 0 0 0 0 3 0 0 0 8 0 0 8 0 0 
1 1 1 1 1 1 1 1 1 6 1 1 1 3 3 1 1 1 6 1 1 1 1 1 1 1 1 1 
