28 16
0 0 0 0 0 0 0 0 0 0 0 0 0 0 0 0 0 8 0 8 0 8 4 0 0 0 0 0 
0 0 0 0 0 0 0 0 0 0 0 0 0 0 0 3 1 1 1 1 1 1 0 3 1 1 1 3 
0 0 0 0 0 0 0 0 0 0 0 0 0 0 0 3 1 0 0 0 0 1 0 3 1 1 1 3 
0 0 0 0 0 0 0 0 0 0 0 3 1 1 1 1 1 1 0 0 0 1 0 3 1 1 1 3 
0 0 0 0 0 0 0 0 0 0 0 3 1 0 0 0 0 1 0 0 0 1 0 3 1 1 1 3 
0 0 0 0 0 0 0 3 1 1 1 1 1 1 0 0 0 1 7 7 7 1 0 3 1 1 1 3 
0 0 0 0 0 0 0 3 1 0 0 0 0 1 0 0 0 1 1 1 1 1 0 3 1 1 1 3 
0 0 0 3 1 1 1 1 1 1 0 0 0 1 7 7 7 1 0 0 0 0 0 3 1 1 1 3 
0 0 8 3 1 0 0 0 0 1 0 0 0 1 1 1 1 1 0 3 1 1 1 1 1 1 1 3 
1 1 1 1 1 1 0 0 0 1 7 7 7 1 0 0 0 0 8 3 1 0 0 0 0 1 1 3 
1 0 0 0 0 1 0 0 0 1 1 1 1 1 0 3 1 1 1 1 1 1 0 0 0 1 1 3 
1 0 0 0 0 1 7 7 7 1 0 0 0 0 0 3 1 0 0 0 0 1 0 0 0 1 1 3 
1 0 0 0 0 1 1 1 1 1 0 3 1 1 1 1 1 0 7 7 7 1 7 7 7 1 1 3 
1 7 7 7 7 1 0 0 0 0 0 3 1 2 2 2 2 2 2 1 2 2 2 1 2 2 2 3 
1 1 1 1 1 1 0 3 1 1 1 1 1 0 0 0 0 0 0 0 0 9 0 0 0 0 0 3 
0 0 0 0 0 0 0 3 1 1 1 1 1 1 1 1 1 1 1 1 1 1 1 1 1 1 1 1 
