28 16
0 4 4 4 4 0 0 0 0 0 0 0 0 8 9 0 0 0 0 0 0 0 0 4 4 4 4 0 
3 0 0 0 0 1 1 3 7 0 0 0 0 0 0 0 0 0 0 7 3 1 1 0 0 0 0 3 
3 0 0 0 0 1 1 3 7 0 0 0 0 0 0 0 0 0 0 7 3 1 1 0 0 0 0 3 
3 0 0 0 0 0 1 1 3 7 0 0 0 0 0 0 0 0 7 3 1 1 0 0 0 0 0 3 
3 7 0 7 0 0 1 1 3 7 0 0 0 0 0 0 0 0 7 3 1 1 0 0 7 0 7 3 
3 1 1 1 1 3 0 1 1 3 7 0 0 0 0 0 0 7 3 1 1 0 3 1 1 1 1 3 
3 7 0 0 7 3 0 1 1 3 7 0 0 0 0 0 0 7 3 1 1 0 3 7 0 0 7 3 
3 1 1 1 1 1 3 0 1 1 3 7 0 0 0 0 7 3 1 1 0 3 1 1 1 1 1 3 
3 7 8 0 8 7 3 0 1 1 3 7 0 0 0 0 7 3 1 1 0 3 7 8 0 8 7 3 
3 1 1 1 1 1 1 3 0 1 1 3 7 0 0 7 3 1 1 0 3 1 1 1 1 1 1 3 
3 7 0 0 0 0 7 3 0 1 1 3 7 0 0 7 3 1 1 0 3 7 0 0 0 0 7 3 
3 1 1 1 1 1 1 1 3 0 1 1 3 7 7 3 1 1 0 3 1 1 1 1 1 1 1 3 
3 7 0 0 0 0 0 7 3 0 1 1 1 1 1 1 1 1 0 3 7 0 0 0 0 0 7 3 
3 1 1 1 1 1 1 1 1 3 0 1 1 1 5 1 1 0 3 1 1 1 1 1 1 1 1 3 
3 7 0 0 0 0 0 0 7 3 0 7 7 1 5 7 7 0 3 7 0 0 0 0 0 0 7 3 
1 1 1 1 1 1 1 1 1 1 1 1 1 2 2 1 1 6 1 1 1 1 1 1 1 1 1 1 
