28 16
0 0 0 0 0 0 0 0 0 0 0 0 0 0 0 0 0 0 0 0 0 0 0 0 6 0 0 0 
0 0 0 7 0 0 0 0 0 0 0 0 0 0 0 0 0 0 0 0 0 0 0 0 6 0 0 0 
3 2 1 1 0 0 0 0 0 0 0 0 0 0 0 0 0 0 0 0 0 0 0 0 6 2 2 3 
3 2 7 1 1 0 7 0 0 0 0 0 0 0 0 0 0 0 0 0 0 0 0 7 6 2 2 3 
3 0 0 1 7 1 1 1 0 0 0 0 0 0 0 0 0 0 8 0 1 1 1 1 1 1 1 3 
3 0 0 1 0 1 0 0 1 1 1 7 0 0 0 0 0 1 1 1 0 7 0 0 0 0 0 3 
3 4 4 0 0 1 7 0 1 0 0 1 0 0 7 0 1 1 7 0 2 2 2 2 0 0 0 3 
3 0 0 1 1 1 1 1 1 0 0 0 1 1 1 5 1 0 0 0 0 0 0 1 1 1 2 3 
3 7 0 9 0 0 0 0 0 0 0 0 0 0 0 0 0 1 2 2 2 3 1 0 7 0 0 3 
3 2 2 2 2 4 4 4 4 4 4 4 4 0 0 0 0 0 0 0 0 3 1 1 1 7 0 3 
3 0 0 0 2 0 0 0 0 8 7 7 7 7 0 0 0 0 0 0 0 3 0 0 1 1 1 1 
3 0 7 0 2 7 0 0 2 2 2 2 2 2 2 2 2 2 0 0 0 3 0 7 2 0 0 7 
3 1 1 1 1 1 0 0 0 0 0 0 0 0 0 0 0 0 0 0 0 3 1 1 2 2 1 1 
3 4 4 4 4 3 4 4 4 4 4 4 0 0 0 0 0 0 0 0 0 3 0 0 0 0 0 0 
0 0 0 0 0 3 0 0 0 0 0 0 0 0 0 0 0 0 0 0 0 3 8 0 0 0 0 0 
0 0 0 7 0 3 0 0 0 1 1 1 1 1 1 1 1 1 1 1 1 1 1 1 1 1 1 1 
