28 16
4 4 4 4 4 4 4 4 4 4 4 4 4 4 4 4 4 4 4 4 4 4 4 3 0 0 0 0 
0 0 7 0 0 0 0 7 0 0 0 0 0 7 0 0 0 0 0 7 0 0 0 3 0 0 0 0 
1 1 1 1 0 0 1 1 1 1 0 0 1 1 1 5 0 0 1 1 5 1 0 3 0 0 0 0 
0 0 0 0 0 7 0 0 0 0 7 0 0 0 0 0 0 7 0 0 0 0 0 3 0 0 0 0 
1 0 0 1 5 1 1 0 0 1 1 5 1 0 0 5 1 1 1 0 0 1 0 3 0 0 0 0 
0 7 0 0 0 0 0 0 7 0 0 0 7 0 0 0 0 0 0 7 0 0 0 3 0 0 0 0 
1 1 1 1 0 0 1 1 1 1 0 0 1 1 1 5 0 0 1 1 5 1 0 3 0 0 0 0 
0 0 0 0 7 0 0 0 0 0 7 0 0 0 0 0 7 0 0 0 0 0 0 3 0 0 0 0 
1 0 0 1 1 5 1 0 0 1 5 1 1 0 0 5 1 1 1 0 0 1 0 3 0 0 0 0 
0 0 7 0 0 0 0 0 7 0 0 0 0 0 7 0 0 0 0 7 0 0 0 3 0 0 0 0 
1 1 1 1 0 0 1 1 1 1 0 0 1 1 1 5 0 0 1 1 5 1 0 3 0 0 0 0 
8 0 0 0 0 9 0 0 0 0 0 0 0 0 0 0 0 8 0 0 0 0 0 3 0 0 0 8 
1 1 1 1 1 1 1 1 1 1 1 1 1 1 1 1 1 1 1 1 1 1 1 1 6 1 1 1 
1 1 1 1 1 1 1 1 1 1 1 1 1 1 1 1 1 1 1 1 1 1 1 1 6 1 1 1 
1 1 1 1 1 1 1 1 1 1 1 1 1 1 1 1 1 1 1 1 1 1 0 0 6 0 0 1 
1 1 1 1 1 1 1 1 1 1 1 1 1 1 1 1 1 1 1 1 1 1 0 8 6 8 0 1 
