28 16
0 0 0 0 0 0 0 0 0 0 0 0 0 3 3 0 0 0 0 0 0 0 0 0 0 0 0 0 
0 0 8 3 0 0 0 0 0 0 0 0 0 3 3 0 0 0 0 0 0 0 0 0 3 0 8 0 
0 1 1 3 1 1 0 0 0 0 0 1 1 3 3 1 1 0 0 0 0 0 1 1 3 1 1 0 
1 1 7 3 7 1 1 0 0 0 1 1 1 3 3 1 1 1 0 0 0 1 1 7 3 7 1 1 
1 0 0 3 0 0 0 0 0 1 1 7 0 3 3 0 7 1 1 0 0 1 0 0 3 0 0 0 
1 1 7 3 7 0 4 4 4 1 1 0 0 3 3 0 0 0 0 0 0 1 1 7 3 7 0 0 
0 1 1 3 1 1 0 0 0 1 1 7 0 3 3 8 7 0 0 0 0 0 1 1 3 1 1 0 
0 0 7 3 7 1 1 0 0 0 1 1 1 3 3 1 1 0 0 0 0 0 0 7 3 7 1 1 
0 0 0 3 0 0 1 0 0 0 0 1 1 3 3 1 1 1 0 4 4 0 0 0 3 0 0 1 
1 1 7 3 7 1 1 0 0 0 0 7 0 3 3 0 7 1 1 0 0 1 1 7 3 7 1 1 
0 1 5 3 5 1 0 0 0 0 0 0 0 3 3 0 0 1 1 0 0 0 1 1 3 5 1 0 
0 0 0 3 0 0 0 0 0 1 1 7 0 3 3 8 7 1 1 0 0 0 0 0 3 0 0 0 
0 0 0 0 0 0 0 0 0 0 1 1 1 3 3 1 1 1 0 0 0 0 0 0 0 0 0 0 
0 0 0 0 0 0 0 0 0 0 0 1 1 3 3 1 1 0 0 0 0 0 0 0 0 0 0 0 
0 0 0 0 0 0 0 0 9 0 0 0 0 3 3 0 0 0 0 0 0 0 0 0 0 0 0 0 
1 1 1 1 1 1 1 1 1 1 1 1 1 3 3 1 1 1 1 1 1 1 1 1 1 1 1 1 
