28 16
6 0 0 0 0 0 0 0 0 0 0 0 0 0 0 0 0 0 0 0 0 0 0 0 0 0 0 0 
6 0 0 0 0 0 0 8 0 0 0 0 0 0 0 0 0 0 7 0 0 0 0 0 0 0 0 0 
6 0 2 2 3 2 2 2 2 0 0 0 0 0 0 0 0 0 2 2 2 2 3 2 2 2 2 2 
6 0 0 0 3 0 0 0 0 1 7 0 0 0 0 0 0 1 0 0 0 0 3 1 0 4 4 4 
6 4 4 4 3 4 4 4 4 4 1 0 0 0 0 0 1 4 4 4 4 4 3 2 3 0 0 7 
1 7 0 0 3 0 0 7 0 0 0 1 0 0 0 1 0 0 0 0 0 0 3 1 3 4 4 0 
0 1 8 0 3 4 4 4 0 1 3 0 1 0 1 0 0 0 7 0 0 0 3 2 0 0 0 3 
0 0 1 0 0 0 0 0 1 0 3 0 0 5 0 0 0 0 0 0 0 0 3 1 7 0 0 3 
9 0 0 1 0 0 0 1 0 0 3 0 0 0 0 0 0 0 0 0 7 0 3 2 0 4 4 3 
2 2 1 0 1 0 1 0 0 0 3 1 0 4 4 4 4 4 4 0 1 0 3 1 3 0 0 0 
0 0 0 0 1 5 0 0 0 0 3 0 1 0 7 0 0 0 0 1 0 0 3 2 3 0 8 0 
7 3 1 1 1 0 0 0 0 0 3 0 0 1 0 0 0 0 1 0 7 0 3 1 1 1 1 3 
1 3 2 4 4 4 4 4 4 4 3 0 0 0 1 0 0 1 0 0 1 1 3 1 1 1 1 3 
0 3 0 0 0 0 0 0 0 0 0 0 0 0 0 5 5 0 0 0 0 0 3 0 0 0 0 3 
0 3 0 0 0 0 0 0 0 0 0 0 0 0 0 0 0 0 0 0 0 0 3 0 0 0 0 3 
2 2 2 2 2 2 1 1 1 1 1 1 1 2 2 2 2 1 1 1 1 2 2 2 2 2 2 2 
