28 16
6 0 0 0 0 0 0 0 0 0 0 0 0 0 0 0 0 0 0 0 0 0 0 0 0 0 0 0 
6 0 0 0 7 0 0 0 7 0 0 0 7 8 0 8 7 0 0 0 7 0 0 0 7 0 0 0 
1 1 1 1 1 1 1 1 1 1 1 1 1 1 6 1 1 1 1 1 1 1 1 1 1 1 1 1 
0 0 0 0 0 0 0 0 0 0 0 0 0 0 3 0 0 0 0 0 0 0 0 0 0 0 0 0 
0 0 0 0 0 0 0 0 0 0 0 0 0 1 3 1 0 0 0 0 0 0 0 0 0 0 0 0 
0 0 0 0 0 0 0 0 0 0 0 0 0 7 3 7 0 0 0 0 0 0 0 0 0 0 0 0 
0 0 0 8 0 0 0 0 0 0 0 0 1 1 3 1 1 0 0 0 0 0 0 0 8 0 0 0 
0 0 0 3 0 0 0 0 0 0 0 0 7 0 3 0 7 0 0 0 0 0 0 0 3 0 0 0 
0 0 1 3 1 0 0 0 0 0 0 1 1 1 3 1 1 1 0 0 0 0 0 1 3 1 0 0 
0 0 7 3 7 0 0 0 0 0 0 7 0 0 3 0 0 7 0 0 0 0 0 7 3 7 0 0 
0 1 1 3 1 1 0 0 0 0 1 1 1 1 3 1 1 1 1 0 0 0 1 1 3 1 1 0 
0 7 0 3 0 7 0 0 0 0 7 0 0 0 3 0 0 0 7 0 0 0 7 0 3 0 7 0 
1 1 1 3 1 1 1 0 0 1 1 1 1 1 3 1 1 1 1 1 0 1 1 1 3 1 1 1 
7 0 0 3 0 0 7 0 0 7 0 0 0 0 3 0 0 0 0 7 0 7 0 0 3 0 0 7 
0 0 0 3 0 0 0 0 0 0 0 0 0 0 3 0 9 0 0 0 0 0 0 0 3 0 0 0 
1 1 1 1 1 1 1 1 1 1 1 1 1 1 1 1 1 1 1 1 1 1 1 1 1 1 1 1 
