28 16
0 0 0 0 0 0 0 0 0 0 0 0 6 0 0 0 0 0 0 0 0 0 0 0 0 0 0 0 
1 0 0 0 0 0 0 0 0 0 1 7 6 7 1 0 0 0 0 0 0 0 0 0 1 0 0 0 
0 1 4 4 4 3 4 4 4 4 4 1 3 1 4 4 4 4 4 3 4 4 4 1 0 0 0 0 
0 0 1 7 0 3 0 8 0 0 0 7 3 7 0 0 0 8 0 3 0 7 1 0 0 0 0 0 
0 0 0 1 4 3 4 3 4 4 4 1 3 1 4 4 4 3 4 3 4 1 0 0 0 0 0 0 
0 0 0 0 1 0 0 3 0 0 5 0 3 0 5 0 0 3 0 0 1 0 0 0 0 0 0 0 
0 3 4 4 4 1 0 3 0 1 4 4 3 4 4 1 0 3 0 1 4 4 4 4 4 4 3 0 
0 3 4 3 0 0 1 3 1 0 0 0 0 0 0 0 1 3 1 0 0 0 0 0 3 4 3 0 
0 0 0 3 0 0 1 3 1 0 0 0 0 0 0 0 1 3 1 0 0 0 0 0 3 0 0 0 
0 3 4 3 0 0 1 3 1 0 9 0 7 0 0 0 1 3 1 1 1 1 0 0 3 4 3 0 
0 3 0 0 0 0 1 3 1 1 1 1 1 1 1 1 1 3 1 1 1 1 0 0 0 0 3 0 
0 3 4 3 0 0 1 3 1 0 1 1 1 1 1 0 1 3 1 1 7 1 0 0 3 4 3 0 
0 0 7 3 0 0 1 3 1 0 1 1 7 1 1 0 1 3 1 1 1 1 0 0 3 7 0 0 
0 3 4 3 8 0 1 3 1 0 1 1 1 1 1 0 1 3 1 0 0 0 0 8 3 4 3 0 
0 3 4 4 4 4 0 3 0 4 0 0 0 0 0 4 0 3 0 4 4 4 4 4 4 4 3 0 
0 3 0 0 0 0 1 3 1 0 1 1 1 1 1 0 1 3 1 0 0 0 0 0 0 0 3 0 
