28 16
0 0 3 0 0 0 8 0 0 0 0 4 0 0 0 8 4 3 0 0 0 0 3 4 0 0 0 7 
0 4 3 0 0 0 4 3 4 0 0 0 4 0 0 4 0 3 4 0 0 0 3 0 4 0 0 3 
4 0 3 0 0 4 0 3 0 4 0 0 0 0 4 0 0 3 0 4 0 0 3 0 0 4 0 3 
7 0 3 0 4 0 0 3 0 0 4 0 0 4 0 0 0 3 0 0 4 7 3 0 0 0 4 3 
0 0 3 4 0 0 4 3 0 0 0 4 4 0 0 0 0 3 7 0 0 4 3 0 0 0 0 3 
3 4 0 0 0 4 0 3 4 0 0 4 4 0 0 4 0 3 4 4 4 4 4 4 0 4 0 0 
3 0 4 0 0 0 4 3 0 0 4 7 0 4 0 0 0 3 0 0 4 0 0 0 3 0 4 0 
3 4 0 4 0 0 0 3 7 4 4 3 0 0 4 0 0 3 0 0 0 0 0 4 3 0 0 4 
3 0 4 0 4 0 0 3 4 4 0 3 0 0 0 4 0 3 0 0 0 0 4 0 3 0 0 4 
3 4 0 7 0 4 8 3 4 0 0 3 0 4 0 0 4 3 4 0 0 4 0 0 3 0 0 4 
3 0 4 3 0 0 4 0 0 0 0 3 0 0 0 4 0 0 0 4 0 0 0 0 3 0 0 4 
3 4 0 3 0 0 0 4 0 0 0 3 0 0 4 0 4 0 0 0 4 0 0 0 3 0 0 4 
3 0 4 3 0 4 0 0 4 0 0 3 7 4 0 0 0 4 0 0 0 4 0 0 3 0 7 4 
3 4 0 3 0 0 0 4 0 4 0 3 4 0 4 0 0 7 4 0 0 0 4 0 3 0 4 0 
3 0 4 3 0 0 4 0 0 0 4 3 0 0 0 0 0 4 0 4 0 4 0 4 3 4 0 0 
0 0 0 3 0 0 0 0 0 7 0 0 0 0 0 7 9 0 0 0 0 0 0 0 3 0 0 0 
