28 16
4 4 4 4 4 4 4 4 4 4 4 4 4 3 4 4 4 4 4 4 4 4 4 4 4 4 4 4 
0 7 0 0 0 0 0 0 7 0 0 0 0 3 0 0 0 7 0 0 0 7 0 8 7 0 0 7 
8 7 0 0 7 0 0 0 0 8 0 7 0 3 0 7 0 0 0 7 0 7 0 0 0 0 0 0 
0 1 5 1 1 5 1 3 0 3 1 5 1 1 1 1 3 0 3 1 5 1 0 0 0 0 0 0 
0 1 5 1 1 5 1 1 3 3 1 5 1 1 1 1 5 3 3 1 5 1 0 0 0 0 0 0 
0 1 5 1 1 5 1 1 5 3 1 5 1 1 1 1 5 1 3 1 5 1 0 0 0 0 0 0 
0 1 5 1 0 0 1 1 5 3 1 5 1 0 0 1 5 1 3 1 5 1 0 0 0 0 0 0 
0 1 5 1 0 0 1 1 5 3 1 5 1 0 0 1 5 1 3 1 5 1 0 0 0 0 0 0 
0 1 5 1 0 0 1 1 5 3 1 5 1 0 0 1 5 1 3 1 5 1 0 0 0 0 0 0 
0 1 5 1 0 0 1 1 5 3 1 5 1 0 0 1 5 1 3 1 5 1 0 0 0 0 0 0 
0 1 5 1 0 7 1 1 5 3 1 5 1 0 7 1 5 1 3 1 5 1 0 0 0 0 0 0 
0 1 5 1 5 1 1 1 5 3 1 5 1 5 1 1 5 1 3 1 5 1 1 1 5 1 1 0 
0 1 5 1 5 1 1 1 0 3 1 5 1 5 1 1 5 0 3 1 5 1 1 1 5 1 1 0 
0 1 5 1 5 1 1 0 0 3 1 5 1 5 1 1 0 0 3 1 5 1 1 1 5 1 1 0 
0 0 0 0 0 0 0 0 0 3 0 0 0 9 0 0 0 0 3 0 0 0 0 0 0 0 0 0 
1 1 1 1 1 1 1 1 1 1 1 1 1 1 1 1 1 1 1 1 1 1 1 1 1 1 1 1 
