28 16
1 6 0 0 0 0 0 0 0 0 0 0 0 0 0 0 0 0 0 0 0 0 0 0 0 0 0 1 
1 6 4 4 4 4 4 4 4 4 4 4 4 4 4 4 4 4 4 4 4 4 4 4 4 4 4 1 
1 6 0 0 0 0 0 0 0 5 1 1 1 3 1 1 1 5 0 0 0 0 0 0 0 0 0 1 
1 6 0 0 0 0 7 5 1 5 0 0 0 3 0 0 0 5 1 1 0 7 0 0 0 0 0 1 
1 6 0 0 7 5 1 5 7 7 7 7 7 3 7 7 8 7 7 1 5 1 0 7 0 0 0 1 
1 6 0 1 1 5 1 5 1 1 1 1 1 3 1 1 1 1 1 1 5 1 5 1 0 7 0 1 
1 1 1 1 0 0 0 0 0 0 0 0 0 3 0 0 0 0 0 0 0 0 0 1 5 1 5 1 
1 1 0 0 0 0 0 7 7 7 7 0 0 3 8 0 7 7 7 7 0 0 0 0 0 1 5 1 
1 0 0 0 0 3 1 1 1 1 1 1 5 3 1 1 1 1 1 1 1 3 0 0 0 0 0 1 
1 0 0 0 0 3 0 0 0 0 0 0 0 3 0 0 0 0 0 0 0 3 0 0 0 0 0 1 
1 0 0 0 7 3 0 0 7 7 7 7 7 3 0 7 0 7 7 7 7 3 0 8 0 0 0 1 
1 0 3 5 1 1 1 1 1 1 1 1 1 3 5 1 1 1 1 1 1 1 1 1 3 0 0 1 
1 0 3 0 0 0 0 0 0 0 0 0 0 3 0 0 0 0 0 0 0 0 0 0 3 0 0 1 
1 0 3 0 0 0 0 0 0 0 0 0 0 3 0 0 0 0 0 0 0 0 0 0 3 0 0 1 
1 0 3 0 0 0 0 0 0 0 0 0 0 3 0 0 9 0 0 0 0 0 0 0 3 0 0 1 
1 1 1 1 1 1 1 1 1 1 1 1 1 1 1 1 1 1 1 1 1 1 1 1 1 1 1 1 
