28 16
7 8 0 0 0 0 0 1 1 1 1 1 1 1 1 1 1 1 1 1 1 1 1 1 1 1 1 1 
1 1 3 0 0 0 0 1 1 1 1 1 1 1 1 1 1 1 1 1 1 1 1 1 1 1 1 1 
3 1 1 1 1 3 0 0 0 0 1 1 1 1 1 1 1 1 1 1 1 1 1 1 1 1 1 1 
3 1 1 1 1 1 1 1 3 0 8 0 0 1 1 1 1 1 1 1 1 1 1 1 1 1 1 1 
3 1 1 1 1 1 0 1 1 1 1 3 0 0 0 0 1 1 1 1 1 1 1 1 1 1 1 1 
3 1 1 1 1 1 0 1 1 1 1 1 1 1 3 0 0 0 0 1 1 1 1 1 1 1 1 1 
3 1 1 1 1 1 0 1 1 1 1 1 1 1 1 1 1 3 0 8 0 0 1 1 1 1 1 1 
3 1 1 1 1 0 7 0 1 1 1 1 1 1 1 1 1 1 1 1 3 0 0 0 0 1 1 1 
3 1 1 1 1 1 1 1 0 7 0 1 1 1 1 1 1 1 1 1 1 1 1 3 0 0 0 0 
3 1 1 1 1 1 0 1 1 1 1 0 7 0 1 1 1 1 1 1 1 1 1 1 1 1 1 3 
3 1 1 1 1 1 0 1 1 1 1 1 1 1 0 7 0 1 1 1 1 1 1 1 1 1 1 3 
3 1 1 1 1 1 0 1 1 1 1 1 1 1 1 1 3 0 7 0 1 1 1 1 1 1 1 3 
3 1 1 1 1 1 0 1 1 1 1 1 1 1 1 1 3 1 1 1 0 1 1 1 1 1 1 3 
3 7 0 0 0 7 0 0 0 7 0 0 0 7 0 1 3 1 1 1 0 1 1 1 1 1 1 3 
1 1 1 1 1 1 1 1 1 1 1 1 1 1 0 0 3 1 1 1 0 0 0 0 0 0 9 3 
1 1 1 1 1 1 1 1 1 1 1 1 1 1 1 1 1 1 1 1 1 1 1 1 1 1 1 1 
