28 16
0 0 0 0 0 0 0 0 0 0 0 0 0 0 0 0 0 0 0 0 0 0 0 0 0 0 0 6 
4 4 4 4 4 4 4 4 0 1 3 0 0 0 0 0 0 0 0 0 0 0 0 7 0 0 7 6 
0 0 0 7 1 7 0 0 3 1 3 1 2 1 2 1 2 1 2 1 2 5 2 1 2 1 2 1 
0 0 7 1 0 1 7 0 3 1 3 0 0 0 0 7 0 0 0 7 0 0 4 4 4 4 4 4 
0 7 1 0 0 0 1 7 3 1 1 2 1 2 1 2 1 2 1 2 1 3 0 0 0 0 0 3 
0 1 0 0 0 0 0 5 3 1 2 2 2 2 2 2 2 2 2 2 2 3 0 0 7 0 0 3 
0 0 0 0 0 0 0 0 3 4 4 4 4 4 4 4 4 4 4 3 1 1 1 5 1 1 1 3 
0 0 0 0 0 0 0 0 0 0 0 0 0 0 0 0 0 0 0 3 1 0 0 0 0 0 0 3 
0 0 7 0 9 7 0 0 0 0 0 0 0 0 0 0 0 0 0 3 1 0 0 0 0 0 0 3 
3 1 1 1 1 1 1 1 3 0 8 0 7 0 0 7 0 0 0 3 1 0 7 0 0 7 8 3 
3 0 8 7 0 0 7 0 3 1 2 1 2 1 2 1 2 1 2 1 2 2 1 2 5 2 1 3 
3 1 1 1 1 1 1 1 3 1 1 1 1 1 1 7 0 1 1 1 0 0 0 0 0 0 0 3 
3 0 0 7 0 7 0 0 3 1 1 1 1 1 1 1 1 0 1 1 0 0 0 0 0 0 0 3 
3 1 1 1 1 1 1 1 3 1 1 1 1 1 1 1 1 1 0 1 0 0 0 0 0 0 0 3 
3 0 0 0 7 0 7 0 3 1 1 1 1 1 1 1 1 1 1 0 0 7 0 0 7 0 0 3 
1 1 1 1 1 1 1 1 1 1 1 1 1 1 1 1 1 1 1 1 1 1 1 1 1 1 1 1 
