28 16
0 0 0 0 0 0 0 0 0 0 0 0 8 0 0 0 0 0 0 0 0 0 0 8 0 0 0 0 
5 3 5 3 5 3 5 3 5 3 5 3 5 3 5 3 5 3 5 3 5 3 5 3 5 3 5 6 
5 3 5 3 5 3 5 3 5 3 5 3 5 3 5 3 5 3 5 3 5 3 5 3 5 3 5 6 
7 3 1 3 0 3 1 3 7 3 1 3 0 3 1 3 7 3 1 3 0 3 1 3 7 3 1 6 
5 3 1 3 5 3 1 3 5 3 1 3 5 3 1 3 5 3 1 3 5 3 1 3 5 3 1 6 
5 3 1 3 5 3 1 3 5 3 1 3 5 3 1 3 5 3 1 3 5 3 1 3 5 3 1 6 
5 3 1 3 5 3 1 3 5 3 1 3 5 3 1 3 5 3 1 3 5 3 1 3 5 3 1 6 
0 3 1 3 7 3 1 3 0 3 1 3 7 3 1 3 0 3 1 3 7 3 1 3 0 3 1 6 
5 3 1 3 5 3 1 3 5 3 1 3 5 3 1 3 5 3 1 3 5 3 1 3 5 3 1 6 
5 3 1 3 5 3 1 3 5 3 1 3 5 3 1 3 5 3 1 3 5 3 1 3 5 3 1 6 
7 3 0 3 0 3 0 3 0 3 0 3 0 3 0 3 0 3 0 3 0 3 0 3 0 3 1 6 
3 1 1 1 1 1 1 1 1 1 1 1 1 1 1 1 1 1 1 1 1 1 1 1 1 1 1 6 
3 0 0 0 0 0 0 0 0 0 7 0 8 0 7 0 0 0 7 0 8 0 0 0 0 0 0 6 
3 2 2 2 2 2 2 2 2 2 2 2 2 2 2 2 2 2 2 2 2 2 2 2 2 2 2 6 
3 7 0 0 0 0 0 0 0 9 0 0 0 0 0 0 0 0 0 0 0 0 0 0 0 0 7 6 
1 1 1 1 1 1 1 1 1 1 1 1 1 1 1 1 1 1 1 1 1 1 1 1 1 1 1 1 
