28 16
0 0 0 0 4 4 4 4 4 4 0 0 0 0 0 0 0 0 0 0 0 0 0 0 4 0 0 0 
0 1 1 1 0 0 0 0 0 0 3 4 4 0 0 0 8 0 0 3 1 1 1 1 0 0 0 0 
0 1 7 0 0 0 0 0 0 3 4 4 0 1 1 1 1 1 1 3 1 1 1 1 0 0 0 0 
0 1 1 1 0 0 0 0 0 4 4 0 0 5 1 1 1 1 5 3 1 7 7 1 0 0 0 0 
0 0 0 0 0 1 1 1 5 0 0 0 0 5 1 1 1 1 5 3 1 1 1 1 0 0 0 0 
0 0 0 0 0 1 1 1 5 0 1 1 4 5 1 7 7 1 5 3 0 0 0 0 5 1 1 1 
0 0 0 0 0 1 7 7 5 0 1 1 0 5 1 1 1 1 5 3 0 0 0 0 5 1 1 1 
0 0 0 0 0 1 1 1 5 0 0 0 0 0 0 0 0 0 0 3 0 0 0 0 5 7 7 1 
0 0 0 0 0 0 0 0 0 0 0 0 0 0 0 0 0 0 0 3 0 0 0 0 5 1 1 1 
0 0 0 0 0 0 0 0 0 5 1 1 5 0 0 0 0 0 0 3 0 0 0 0 0 0 0 0 
5 1 1 1 5 0 0 0 0 5 7 7 5 0 0 0 0 0 0 3 5 1 1 1 0 0 0 0 
5 1 1 1 5 0 0 0 0 5 1 1 5 0 0 0 0 0 0 3 5 1 1 1 0 1 1 0 
5 0 7 0 5 0 0 0 0 0 0 0 0 0 0 0 0 0 0 3 5 7 7 1 0 1 1 0 
5 1 1 1 5 0 0 0 0 0 0 0 0 0 0 0 0 0 0 3 5 1 1 1 0 0 0 0 
0 0 0 0 0 0 0 0 0 0 0 0 0 0 8 0 0 0 0 3 0 9 0 0 0 0 0 0 
1 1 1 1 1 1 1 1 1 1 1 1 1 1 1 1 1 1 1 1 1 1 1 1 1 1 1 1 
