28 16
0 0 0 0 0 0 0 0 0 0 0 0 0 0 0 0 0 0 0 0 0 0 0 0 0 0 0 0 
1 1 1 1 1 1 3 6 0 0 0 0 0 0 0 0 0 0 0 0 6 3 1 1 1 1 1 1 
1 1 1 3 3 3 7 6 0 0 0 0 0 0 0 0 0 0 0 0 6 7 3 3 3 1 1 1 
3 3 1 1 1 3 3 3 7 0 0 0 0 0 0 0 0 0 0 7 3 3 3 1 5 1 3 3 
7 3 3 3 1 5 1 3 3 3 7 8 0 0 0 0 8 7 3 3 3 1 1 1 3 3 3 7 
0 0 7 3 3 3 1 1 1 3 3 3 7 0 0 7 3 3 3 1 5 1 3 3 3 7 0 0 
0 0 0 0 7 3 3 3 1 5 1 3 3 3 3 3 3 1 1 1 3 3 3 7 0 0 0 0 
0 0 0 0 0 0 7 3 3 3 1 1 1 3 3 1 1 1 3 3 3 7 0 0 0 0 0 0 
0 0 0 0 0 0 0 0 7 3 3 3 1 3 3 1 3 3 3 7 0 0 0 0 0 0 0 0 
0 0 0 0 0 0 7 3 3 3 1 1 1 3 3 1 1 1 3 3 3 7 0 0 0 0 0 0 
0 0 0 0 7 3 3 3 1 1 1 3 3 3 3 3 3 1 5 1 3 3 3 7 0 0 0 0 
0 0 7 3 3 3 1 5 1 3 3 3 7 0 0 7 3 3 3 1 1 1 3 3 3 7 0 0 
7 3 3 3 1 1 1 3 3 3 7 0 0 0 0 0 0 7 3 3 3 1 5 1 3 3 3 7 
3 3 1 5 1 3 3 3 7 0 0 0 0 0 0 0 0 0 0 7 3 3 3 1 1 1 3 3 
1 1 1 3 3 3 7 6 0 0 0 0 0 0 0 0 0 0 0 0 6 7 3 3 3 1 1 1 
1 1 1 1 1 1 3 6 0 0 0 0 0 0 0 9 0 0 0 0 6 3 1 1 1 1 1 1 
