28 16
1 1 1 1 2 2 1 1 1 1 1 1 1 1 1 1 1 1 1 1 1 1 1 1 1 1 1 6 
1 0 7 0 0 2 0 0 0 0 0 7 0 0 8 0 0 0 0 9 0 0 0 0 0 0 1 6 
1 3 1 3 0 2 1 5 1 3 1 1 1 1 1 1 5 1 1 1 1 1 1 1 1 0 1 6 
1 3 1 1 3 0 1 5 1 3 3 1 1 7 4 4 4 4 4 4 4 4 7 0 0 0 1 6 
1 3 0 1 1 3 0 5 1 1 3 3 1 1 7 0 0 0 7 0 0 7 1 1 3 0 1 6 
1 3 0 0 1 1 3 0 1 1 1 3 3 1 1 7 0 0 0 0 7 1 1 0 3 1 3 6 
1 3 3 0 0 1 1 3 0 1 1 3 3 3 1 1 7 0 0 7 1 1 0 0 3 3 3 6 
1 3 3 3 7 0 1 3 3 0 1 3 1 3 3 1 1 0 0 1 1 0 0 1 3 3 1 6 
1 3 3 3 3 0 0 3 1 3 0 3 1 1 3 3 1 5 1 1 0 0 1 3 3 3 1 6 
1 7 3 3 3 3 8 3 1 1 3 3 1 1 1 3 3 5 1 0 0 3 3 3 7 3 1 6 
1 3 3 7 0 0 3 3 0 1 1 3 0 1 1 1 3 5 0 7 1 3 3 3 3 1 1 6 
1 1 1 3 1 1 1 1 7 0 1 1 3 0 1 1 3 0 0 1 3 3 3 8 3 3 1 6 
1 3 3 3 3 3 3 3 3 0 0 1 3 3 0 3 3 8 3 3 3 7 0 0 3 3 1 6 
1 3 0 3 3 0 7 0 0 3 0 0 3 1 3 3 3 1 3 3 1 1 1 1 1 3 1 6 
1 7 0 3 1 3 1 1 1 1 3 0 0 0 0 0 3 3 3 7 0 0 0 0 0 3 0 6 
1 1 1 1 1 3 3 3 3 7 3 1 1 1 1 1 3 3 1 1 1 1 1 1 1 1 1 1 
