28 16
0 0 8 0 4 4 0 4 0 0 0 0 0 0 0 0 0 0 0 0 0 8 0 0 0 0 0 0 
1 1 1 1 0 0 3 0 0 0 4 0 0 0 0 0 0 0 0 0 1 1 3 0 0 0 0 0 
1 1 1 1 0 0 3 0 1 1 0 4 0 0 0 8 0 0 0 4 1 1 3 0 0 0 0 0 
1 7 7 1 0 0 3 0 1 1 4 0 1 1 1 1 1 1 1 0 0 4 3 0 0 0 0 0 
1 1 1 1 0 0 3 0 0 0 0 0 1 1 1 1 1 1 1 0 3 0 3 1 1 1 0 0 
0 0 0 0 0 0 3 4 4 4 0 0 1 1 1 1 1 1 1 0 3 0 0 1 7 1 0 0 
0 0 0 0 4 0 0 0 0 0 3 0 1 1 1 1 1 1 1 0 3 0 0 1 1 1 0 0 
0 0 0 0 0 1 1 1 1 0 3 0 1 1 7 7 7 1 1 0 3 0 0 0 0 0 0 0 
0 0 0 4 0 1 1 1 1 0 3 0 1 1 1 1 1 1 1 0 3 0 0 0 0 0 0 0 
1 1 1 4 0 1 7 7 1 0 3 4 0 0 0 0 0 4 0 4 3 0 0 0 0 0 0 0 
1 7 1 0 0 1 1 1 1 0 3 0 4 0 0 0 4 0 3 0 0 1 1 1 1 0 0 0 
1 1 1 0 0 0 0 0 0 0 3 0 0 0 9 0 0 0 3 0 0 1 1 1 1 0 0 0 
0 0 0 0 0 0 0 0 0 0 3 0 0 1 1 1 0 0 3 0 0 1 7 7 1 0 0 0 
0 0 0 1 1 0 0 0 0 0 3 0 0 1 7 1 0 0 3 0 0 1 1 1 1 0 0 0 
0 0 0 1 1 0 0 0 0 0 3 0 0 1 5 1 0 0 3 0 0 0 0 0 0 0 0 0 
0 0 0 0 0 0 0 0 0 0 3 0 0 0 0 0 0 0 3 0 0 0 0 0 0 0 0 0 
