28 16
2 0 0 0 0 0 0 0 0 0 0 0 0 0 0 0 0 0 0 0 0 0 0 0 0 0 0 6 
2 0 0 0 0 0 7 7 7 7 8 0 8 0 8 0 0 0 0 0 0 9 0 0 0 0 0 6 
2 1 1 1 1 1 1 1 1 1 1 5 1 1 1 1 1 1 1 1 1 1 1 1 1 1 1 3 
0 0 0 0 0 0 0 0 0 0 0 0 0 0 0 0 0 0 0 0 0 0 0 0 0 0 0 3 
0 0 0 0 2 0 7 0 0 7 0 0 0 0 0 0 0 7 0 0 0 0 0 0 7 2 0 3 
0 0 0 0 2 1 1 1 1 1 1 1 5 1 1 1 1 1 1 1 5 1 1 1 1 2 0 3 
0 0 0 0 0 0 0 0 0 0 0 0 0 0 0 0 0 0 0 0 0 0 0 0 0 0 0 3 
0 0 0 0 0 0 2 0 0 7 0 0 0 0 7 0 0 0 0 0 7 0 0 2 0 0 0 3 
0 0 0 0 0 0 2 1 1 1 5 1 1 1 1 1 1 5 1 1 1 1 1 2 0 0 0 3 
0 0 0 0 0 0 0 0 0 0 0 0 0 0 0 0 0 0 0 0 0 0 0 0 0 0 0 3 
0 0 0 0 0 0 0 2 0 0 7 0 0 0 0 0 7 0 0 0 0 7 2 0 0 0 0 3 
0 0 0 0 0 0 2 2 1 1 1 1 1 1 1 1 1 1 1 1 1 1 2 0 0 0 0 3 
0 0 0 0 0 0 0 0 0 0 0 0 0 0 0 0 0 0 0 0 0 0 0 0 0 0 0 3 
0 0 0 0 0 0 0 0 0 0 0 0 0 0 0 0 0 0 0 0 0 0 0 0 0 0 0 3 
7 7 7 7 0 0 0 8 0 0 0 0 0 0 0 0 0 0 8 0 0 0 0 0 3 2 0 3 
1 1 1 1 1 1 1 1 1 1 2 2 2 2 2 2 1 1 1 1 1 1 1 2 2 2 0 3 
