28 16
1 1 1 0 0 6 0 1 1 0 0 0 0 1 1 0 0 0 0 1 1 0 6 0 0 1 1 1 
1 1 1 1 0 6 1 1 1 1 0 8 1 1 1 1 0 8 1 1 1 1 6 0 1 1 1 1 
3 0 0 1 1 3 1 0 0 1 1 3 1 0 0 1 3 1 1 0 0 1 3 1 1 0 0 3 
3 0 0 0 1 3 4 4 3 0 1 3 0 0 0 7 3 1 0 3 4 4 3 1 0 0 0 3 
3 0 8 1 1 1 1 7 3 1 1 1 1 3 3 1 1 1 1 3 7 1 1 1 1 0 9 3 
3 1 1 1 0 0 1 1 3 1 0 0 1 3 1 1 0 0 1 3 1 1 0 0 1 1 1 3 
3 1 1 0 0 0 0 1 3 7 0 0 0 3 1 0 0 0 7 3 1 0 0 0 0 1 1 3 
3 1 1 1 0 0 1 1 1 1 3 3 1 1 1 1 3 3 1 1 1 1 0 0 1 1 1 3 
3 0 0 1 1 3 1 0 0 1 1 3 1 0 0 1 3 1 1 0 0 1 3 1 1 0 0 3 
3 0 0 0 1 3 0 0 0 0 1 3 0 0 0 7 3 1 0 0 0 0 3 1 0 0 0 3 
3 0 0 1 1 1 1 3 3 1 1 1 1 3 3 1 1 1 1 3 3 1 1 1 1 0 0 3 
3 1 1 1 0 0 1 1 3 1 0 0 1 3 1 1 0 0 1 3 1 1 0 0 1 1 1 3 
3 1 1 0 0 0 0 1 3 0 0 0 0 3 1 0 0 0 0 3 1 0 0 0 0 1 1 3 
3 1 1 1 0 0 1 1 1 1 3 3 1 1 1 1 3 3 1 1 1 1 0 0 1 1 1 3 
3 0 0 0 0 7 0 0 0 0 3 3 0 7 0 0 3 3 0 0 0 0 7 0 0 0 0 3 
3 1 1 1 1 1 1 1 1 1 1 1 1 1 1 1 1 1 1 1 1 1 1 1 1 1 1 3 
