28 16
0 0 0 0 0 4 0 0 0 0 0 4 0 4 0 0 0 0 0 0 4 0 0 7 0 0 7 0 
4 0 0 0 4 0 4 0 0 0 4 0 3 0 4 0 0 0 0 4 0 3 1 1 1 1 1 1 
0 4 0 4 0 0 0 4 0 4 0 0 3 0 0 4 0 0 4 0 0 3 0 0 0 0 0 0 
0 0 4 0 0 0 0 0 4 0 0 0 3 0 0 0 4 4 0 0 0 3 0 0 8 0 0 0 
0 7 0 0 0 7 0 0 7 0 0 0 3 0 0 0 4 0 0 0 0 3 2 2 2 2 2 3 
2 2 2 2 2 2 2 5 2 2 2 2 2 2 3 4 0 0 0 0 0 3 2 0 7 0 2 3 
0 0 0 0 0 0 0 0 0 0 0 0 0 0 2 0 0 0 0 0 0 3 2 3 2 7 2 3 
0 0 0 0 0 0 0 0 0 0 0 0 0 7 2 0 0 9 0 7 0 3 2 3 2 7 2 3 
3 1 1 1 1 1 1 1 1 1 1 3 1 2 2 3 1 1 1 1 4 3 2 3 2 7 2 3 
3 0 0 0 0 0 8 0 0 0 0 3 1 1 3 3 0 0 0 0 0 3 2 3 2 7 2 3 
3 0 0 0 0 1 1 0 0 0 0 3 1 1 3 0 0 0 7 8 0 0 2 3 2 7 2 3 
3 0 1 1 1 0 0 1 1 1 0 3 1 1 2 2 1 1 1 1 1 3 2 3 4 4 4 4 
3 0 1 1 1 0 0 1 1 1 0 3 1 1 0 0 0 0 0 0 0 3 0 0 0 0 0 0 
3 0 1 1 1 7 7 1 1 1 0 3 1 0 0 0 0 0 4 4 7 3 0 1 1 1 1 0 
3 0 7 0 7 1 1 7 0 7 0 3 1 1 0 0 3 1 0 0 1 3 1 1 7 7 1 1 
1 1 1 1 1 1 1 1 1 1 1 1 1 1 1 1 1 1 1 1 1 1 1 1 1 1 1 1 
