28 16
3 0 0 0 4 0 0 0 0 0 0 0 0 0 0 0 0 0 0 0 0 0 0 3 4 4 4 4 
3 0 0 0 0 3 0 0 0 0 0 0 0 0 0 0 0 0 0 0 0 0 0 3 0 2 0 0 
3 0 0 0 0 3 0 0 0 0 0 0 0 0 0 0 0 0 0 8 0 0 0 3 0 2 7 7 
3 0 7 0 0 3 1 1 1 1 0 0 7 0 0 7 3 1 1 1 1 1 5 1 3 1 1 1 
3 1 1 0 0 3 0 0 0 1 1 1 1 1 1 1 1 1 0 0 0 0 0 0 3 3 1 5 
3 0 0 0 0 3 0 0 0 0 0 0 0 0 0 0 0 0 0 0 0 0 0 0 0 3 3 5 
3 0 0 0 0 0 3 4 4 4 4 4 4 4 4 4 4 4 4 4 4 4 4 4 4 4 3 3 
3 0 0 0 0 0 3 0 0 0 0 0 0 0 0 0 0 0 0 0 0 0 0 0 0 0 0 3 
3 0 0 0 0 0 3 0 7 0 0 0 0 0 0 0 8 0 0 0 7 0 0 0 0 0 7 3 
3 0 0 0 0 0 1 1 1 1 1 3 2 2 2 2 2 2 2 2 2 2 1 1 5 1 1 1 
3 4 4 4 0 0 0 0 0 0 0 3 0 0 0 0 0 0 0 0 0 0 4 4 4 0 0 0 
0 0 0 8 7 0 0 0 0 0 0 3 0 0 0 0 0 0 0 0 0 3 0 0 0 0 0 0 
1 1 1 1 1 1 1 1 1 3 0 3 0 0 0 7 0 0 0 0 0 3 4 0 0 0 7 0 
0 0 0 0 0 0 0 0 1 1 1 1 1 3 2 2 2 3 1 1 1 1 0 1 7 1 1 1 
7 0 0 0 0 0 0 0 9 0 0 0 0 3 0 0 0 3 0 0 0 8 0 1 1 1 1 1 
1 1 1 1 1 1 1 1 1 1 1 1 1 3 0 0 0 3 1 1 1 1 1 1 1 1 1 1 
