28 16
1 1 1 1 1 1 1 1 1 1 1 1 1 1 1 1 1 1 1 1 1 0 0 0 0 0 6 1 
1 0 9 1 1 4 4 4 0 2 2 0 0 0 7 0 0 0 0 0 0 0 0 0 0 0 6 1 
1 0 1 2 0 0 7 0 3 2 2 1 1 1 1 1 1 3 3 0 3 1 3 0 3 0 6 1 
1 0 1 0 0 0 0 0 3 0 0 0 0 2 2 1 0 3 3 7 3 0 3 0 3 0 6 1 
1 0 1 3 1 1 1 1 2 1 1 7 0 0 0 1 0 3 3 0 3 0 3 1 3 0 6 1 
1 0 1 3 1 0 0 0 0 0 0 2 1 1 0 0 0 3 3 0 3 0 3 0 3 0 6 1 
1 7 0 3 1 0 0 0 7 0 0 1 2 1 0 3 1 0 3 0 3 0 3 0 3 0 6 1 
1 1 3 3 1 1 5 1 2 1 1 1 2 1 0 3 1 7 1 6 1 1 3 1 3 0 6 1 
1 1 3 0 0 0 0 0 0 8 0 0 0 0 0 3 1 5 1 6 1 0 3 0 3 0 6 1 
1 1 3 1 1 2 1 1 1 1 1 1 1 2 3 3 3 0 1 6 1 0 3 0 3 0 6 1 
1 1 3 0 1 2 1 1 1 1 1 1 1 2 3 3 0 0 1 6 1 0 3 0 3 8 3 1 
1 0 3 0 0 2 0 0 7 0 0 0 0 2 3 0 0 0 1 6 1 3 3 1 1 1 3 1 
1 0 3 3 1 2 1 1 1 1 1 1 1 2 3 0 7 0 1 6 1 3 8 0 0 0 3 1 
1 0 1 3 1 2 1 1 1 1 1 1 1 2 3 2 2 2 1 6 1 1 1 1 0 0 3 1 
1 0 1 3 1 0 0 0 0 0 7 0 0 2 2 1 0 0 0 6 0 0 0 1 0 0 3 1 
1 0 7 3 0 1 2 2 2 2 2 2 2 2 2 1 0 8 0 6 0 0 0 1 1 1 1 1 
