28 16
6 0 0 0 0 0 0 0 0 0 0 0 0 0 0 0 0 0 0 0 0 0 0 0 0 0 0 0 
6 0 0 0 0 1 0 0 0 8 0 1 0 0 0 0 0 0 0 8 0 0 0 8 0 0 0 0 
6 4 4 4 4 4 4 7 3 1 3 0 1 1 3 1 1 6 6 1 6 6 1 1 3 0 0 0 
3 0 0 0 0 0 0 1 3 0 1 3 1 0 3 1 0 7 1 0 7 1 0 0 3 0 0 0 
3 0 9 0 0 0 0 0 1 0 0 1 0 3 1 0 3 1 0 0 1 0 0 0 3 0 0 0 
1 1 1 1 1 0 0 0 0 1 1 0 3 1 0 0 1 0 0 1 0 0 0 0 3 0 0 0 
0 0 0 0 1 0 0 0 7 1 0 3 1 0 7 1 0 0 1 0 4 4 4 0 3 0 0 0 
0 0 0 1 0 0 0 0 1 0 3 3 3 0 1 0 0 0 0 1 0 0 1 1 1 1 1 3 
0 7 1 0 0 0 7 1 0 0 1 3 3 1 0 0 1 1 0 0 5 0 0 0 0 0 0 3 
1 1 0 0 0 0 1 0 7 1 0 3 1 0 0 1 0 0 1 0 0 1 0 0 0 0 0 3 
1 0 0 0 7 1 0 0 1 0 3 1 0 0 1 0 0 0 0 1 0 0 1 7 0 0 0 3 
0 0 0 0 1 0 7 1 0 3 1 0 7 1 0 0 3 1 0 0 1 7 0 1 0 0 0 3 
0 0 7 1 0 0 1 0 3 1 0 0 1 0 0 0 3 0 1 0 0 1 0 0 1 0 0 3 
0 0 1 0 7 1 0 3 1 0 0 1 0 0 0 0 3 0 0 1 7 0 1 0 0 1 0 3 
0 1 0 0 1 0 3 3 0 0 0 0 0 7 0 0 3 0 0 0 1 0 0 0 0 0 1 3 
0 0 0 0 0 0 3 1 1 1 1 1 1 1 1 1 1 1 1 1 1 1 1 1 1 0 0 3 
