28 16
3 0 8 0 1 1 0 0 0 0 0 0 0 0 0 0 4 4 4 4 4 4 4 4 4 4 4 4 
3 1 1 1 1 1 0 0 0 0 0 0 0 1 1 3 0 0 0 0 0 0 0 0 0 0 0 0 
3 1 1 1 1 1 0 0 0 0 0 0 0 1 1 3 0 1 2 1 2 1 2 1 2 1 2 1 
3 1 1 1 1 1 0 0 0 0 0 0 0 1 1 3 0 7 0 7 0 7 0 7 0 7 0 7 
3 1 1 7 1 1 0 0 0 0 0 0 0 1 1 3 1 5 1 5 1 5 1 5 1 5 1 5 
3 1 1 1 1 1 0 7 0 0 8 0 0 1 1 3 1 5 1 5 1 5 1 5 1 5 1 5 
3 1 1 1 1 1 1 1 1 1 1 1 1 1 1 3 4 4 4 4 4 4 4 4 4 4 4 4 
3 1 1 1 1 1 1 1 1 1 1 1 1 1 1 3 0 0 0 2 0 2 0 2 0 2 0 2 
3 0 0 9 0 8 0 0 0 0 0 0 0 0 0 3 0 0 0 1 5 1 5 1 5 1 1 1 
3 1 1 1 1 1 1 1 1 3 1 1 1 1 1 1 1 1 3 0 0 0 0 0 5 1 1 1 
3 1 1 1 1 1 1 1 1 3 0 0 0 1 1 1 1 1 3 1 1 1 1 3 5 1 1 1 
3 1 1 1 1 1 1 1 1 3 1 1 7 0 0 1 1 1 3 1 1 1 1 3 5 1 1 1 
3 1 1 1 1 1 1 1 1 3 1 1 1 1 7 0 0 1 3 0 8 0 0 3 5 1 1 1 
0 0 0 0 0 0 0 0 0 3 1 1 1 1 1 1 0 0 3 1 1 1 1 3 5 1 1 1 
0 0 0 0 7 0 7 0 0 3 1 1 1 1 1 1 1 1 3 1 1 1 1 3 5 1 1 1 
1 1 1 1 1 1 1 1 1 1 1 1 1 1 1 1 1 1 3 0 7 7 0 3 5 1 1 1 
