28 16
0 0 0 0 0 0 0 0 0 0 0 0 0 0 0 0 0 0 0 1 1 1 1 1 1 1 0 0 
4 4 4 4 4 4 4 4 4 4 7 0 0 0 0 0 0 8 6 0 1 1 1 1 1 1 0 0 
3 0 0 0 0 0 0 0 0 3 1 3 4 4 4 4 0 0 0 6 0 1 1 1 1 1 1 3 
3 0 0 0 0 0 0 0 3 5 1 5 3 0 7 3 7 0 0 0 6 0 1 1 0 0 1 3 
3 4 4 4 4 4 4 4 3 5 1 5 3 0 1 1 1 3 0 0 0 6 0 1 7 0 1 3 
3 0 0 0 0 0 0 0 3 5 1 5 3 8 1 1 1 3 0 0 0 0 6 0 1 1 1 3 
3 8 0 0 0 0 0 0 3 3 3 3 3 0 1 1 1 3 0 0 0 0 0 6 0 1 1 3 
1 4 4 4 4 4 0 0 2 5 3 5 2 0 1 1 1 3 0 0 0 0 0 0 6 0 1 3 
1 1 7 0 0 3 0 0 2 5 3 5 2 0 0 0 0 3 0 0 0 0 0 0 0 6 6 3 
1 1 1 7 0 3 0 0 2 5 3 5 2 0 3 4 4 3 4 4 4 4 4 4 4 4 4 3 
1 1 1 1 7 3 0 0 2 5 3 5 2 0 3 0 0 0 0 0 0 0 0 0 0 0 0 0 
1 1 1 1 1 3 8 0 2 5 3 5 2 0 3 4 4 4 4 4 4 3 1 1 7 1 1 1 
0 0 0 0 0 3 0 0 2 5 3 5 2 0 3 0 0 0 0 0 3 2 1 1 1 1 1 1 
0 0 0 0 0 3 0 0 2 5 3 5 2 0 3 0 0 0 0 3 2 1 1 1 1 1 1 1 
0 0 0 0 0 3 0 0 0 9 3 0 0 0 3 0 0 0 0 3 2 1 1 1 1 1 1 1 
1 1 1 1 1 1 1 1 1 1 1 1 1 1 1 1 1 1 1 1 1 1 1 1 1 1 1 1 
