28 16
1 1 1 1 1 1 1 3 3 4 4 4 4 4 4 4 4 4 4 3 3 1 1 1 1 1 1 1 
1 1 1 1 1 1 3 3 0 0 0 4 0 0 0 0 4 0 0 0 3 3 1 1 1 1 1 1 
1 1 1 1 1 3 3 0 0 0 0 0 1 8 8 1 0 0 0 0 0 3 3 1 1 1 1 1 
1 1 1 1 3 3 0 0 0 0 4 0 1 1 1 1 0 4 0 0 0 0 3 3 1 1 1 1 
1 1 1 3 3 0 0 0 0 4 0 1 1 1 1 1 1 0 4 0 0 0 0 3 3 1 1 1 
1 1 3 3 4 4 4 4 4 0 1 1 1 1 1 1 1 1 0 4 4 4 4 4 3 3 1 1 
1 3 3 0 0 0 0 4 0 1 1 1 1 7 7 1 1 1 1 0 4 0 0 0 0 3 3 1 
3 3 0 0 0 0 0 0 1 1 1 1 1 1 1 1 1 1 1 1 0 0 0 0 0 0 3 3 
1 3 3 0 0 0 0 4 0 1 1 1 1 7 7 1 1 1 1 0 4 0 0 0 0 3 3 1 
1 1 3 3 0 0 0 0 4 0 1 1 1 1 1 1 1 1 0 4 0 0 0 0 3 3 1 1 
1 1 1 3 3 0 0 0 0 4 0 1 1 1 1 1 1 0 4 0 0 0 0 3 3 1 1 1 
1 1 1 1 3 3 0 0 0 0 4 0 1 1 1 1 0 4 0 0 0 0 3 3 1 1 1 1 
1 1 1 1 1 3 3 0 0 0 0 4 0 0 0 0 4 0 0 0 0 3 3 1 1 1 1 1 
1 1 1 1 1 1 3 3 0 0 0 0 0 0 0 0 0 0 0 0 3 3 1 1 1 1 1 1 
1 1 1 1 1 1 1 3 3 8 0 0 0 9 0 0 0 0 8 3 3 1 1 1 1 1 1 1 
1 1 1 1 1 1 1 1 1 1 1 1 1 1 1 1 1 1 1 1 1 1 1 1 1 1 1 1 
