28 16
1 1 6 1 1 1 1 6 1 1 1 1 1 6 1 1 1 1 1 6 1 1 1 1 1 6 1 1 
1 0 6 7 8 0 0 6 0 0 0 0 0 6 0 0 0 7 0 6 0 7 0 0 0 6 0 1 
1 3 1 1 1 1 1 1 1 1 5 1 1 1 1 5 1 1 1 1 1 1 1 1 1 1 3 1 
1 3 1 7 0 0 0 0 0 0 0 8 7 0 0 0 0 0 0 0 0 7 0 0 0 1 3 1 
1 3 1 1 1 1 1 5 1 1 1 1 1 1 1 1 5 1 1 1 1 1 1 1 3 1 3 1 
1 3 1 0 0 7 0 0 0 0 0 0 0 0 0 0 7 0 0 0 0 0 0 1 3 1 3 1 
1 3 1 3 1 1 1 1 5 1 1 1 1 5 1 1 1 1 1 5 1 1 3 1 3 1 3 1 
1 3 1 3 1 0 0 0 0 0 0 0 0 0 0 0 0 0 0 0 0 1 3 1 3 1 3 1 
1 3 1 3 1 3 1 7 0 0 0 0 0 8 0 0 0 0 0 7 0 1 3 1 3 1 3 1 
1 3 1 3 1 3 1 1 1 5 1 1 5 1 1 1 5 1 1 1 1 1 3 1 3 1 3 1 
1 3 1 3 1 3 0 0 0 7 0 0 0 0 0 0 0 0 7 0 0 0 3 1 3 1 3 1 
1 3 1 3 1 1 1 5 1 1 1 1 1 1 1 1 1 1 1 1 5 1 1 1 3 1 3 1 
1 3 1 3 0 0 0 7 0 0 0 0 0 0 0 0 0 7 0 0 0 0 0 0 3 1 3 1 
1 3 1 1 1 5 1 1 1 1 5 1 1 1 1 5 1 1 1 1 1 1 5 1 1 1 3 1 
1 3 0 0 0 8 0 0 0 7 0 0 0 0 9 0 0 0 0 0 7 0 0 8 0 0 3 1 
1 1 1 1 1 1 1 1 1 1 1 1 1 1 1 1 1 1 1 1 1 1 1 1 1 1 1 1 
