28 16
0 0 0 0 6 0 0 0 0 0 0 0 0 0 0 0 0 0 0 0 0 0 0 0 0 0 0 0 
0 0 0 0 6 0 0 0 0 0 0 0 0 0 0 0 0 0 0 8 0 0 0 0 0 0 0 0 
0 0 0 0 6 0 0 0 0 0 0 0 0 0 0 0 0 3 1 1 1 1 1 3 0 0 0 0 
0 7 3 1 1 1 1 3 1 3 8 0 0 0 0 7 0 3 1 0 0 0 1 3 0 0 0 0 
1 3 1 1 1 1 1 3 1 1 1 1 1 3 1 1 3 1 1 1 1 1 1 3 1 1 1 3 
1 3 0 0 0 0 2 3 0 7 0 0 2 3 0 2 3 0 0 2 1 0 1 3 0 0 7 3 
1 3 0 1 1 1 2 3 0 2 1 0 2 3 0 2 3 0 7 2 1 0 1 3 0 1 1 3 
1 3 0 7 1 1 2 3 0 0 0 7 2 3 0 2 3 0 1 0 1 0 1 3 0 1 1 3 
1 3 0 1 1 1 2 3 0 1 0 1 2 3 0 2 3 0 2 2 0 0 1 3 0 1 1 3 
1 3 0 0 0 7 2 3 0 2 0 0 0 3 7 1 3 0 1 1 7 0 1 3 8 0 7 3 
1 3 1 1 1 1 1 3 1 1 1 1 1 3 5 1 3 1 1 1 1 1 1 3 1 1 1 3 
7 3 4 4 4 4 4 4 4 0 7 7 0 3 0 0 8 0 1 1 0 0 0 0 0 2 7 3 
2 2 2 3 0 0 0 0 1 1 2 2 2 1 1 3 2 2 1 7 0 0 0 0 0 7 2 3 
0 0 0 3 1 1 1 7 1 2 2 2 2 2 1 3 2 2 2 2 2 2 3 2 2 2 2 3 
9 0 0 3 1 7 1 1 7 7 7 7 7 7 0 3 7 0 0 0 0 0 3 0 0 0 0 3 
2 2 2 2 2 2 1 1 1 1 2 2 2 2 2 2 2 1 1 1 1 1 1 1 1 1 1 1 
