28 16
1 0 0 0 0 0 0 0 0 0 0 0 0 0 0 0 0 0 0 0 0 0 0 0 0 0 1 6 
1 0 0 0 0 0 0 7 0 0 8 0 0 0 4 4 4 4 4 4 4 4 4 4 4 7 1 6 
1 1 1 1 1 1 1 1 1 1 1 1 1 3 3 0 0 0 0 8 0 7 0 0 3 1 1 6 
1 1 1 1 0 0 0 0 0 0 0 0 0 3 3 1 1 1 1 1 1 1 1 1 1 1 0 6 
1 1 1 1 1 0 0 7 0 0 8 0 0 3 3 0 0 0 0 0 0 0 0 1 1 0 0 6 
1 1 1 1 1 1 1 1 1 1 1 1 1 3 3 0 0 7 0 0 0 0 1 1 1 3 0 6 
1 1 1 1 1 1 1 0 0 0 0 0 0 3 3 1 1 1 1 1 1 1 1 0 0 3 0 6 
0 0 0 7 0 0 1 1 0 0 7 0 0 3 3 0 0 0 0 0 1 1 1 5 1 3 0 6 
3 1 1 1 1 1 1 1 1 1 1 1 1 3 3 0 7 0 0 1 1 0 0 0 0 3 0 6 
3 1 1 0 1 0 1 1 1 1 0 0 0 3 3 1 1 1 1 1 0 7 0 0 0 3 0 6 
3 0 0 3 1 3 1 0 7 1 1 0 0 3 3 0 0 1 1 1 1 1 5 1 1 3 0 6 
2 2 2 3 0 3 1 3 1 1 1 1 9 3 3 0 1 1 0 7 0 0 0 0 0 3 0 6 
2 2 2 2 2 3 0 3 1 0 1 1 1 3 3 1 1 1 1 1 5 1 1 1 1 3 0 6 
2 2 2 2 2 2 2 3 3 3 1 0 1 3 3 1 0 0 0 0 0 0 0 0 0 3 0 6 
0 0 0 0 0 0 0 0 0 3 0 3 0 3 3 0 0 0 0 0 0 0 0 0 0 3 0 6 
1 1 1 1 1 1 1 1 1 1 1 1 1 1 1 1 1 1 1 1 1 1 1 1 1 1 1 1 
