28 16
0 6 0 0 0 0 0 0 0 0 0 0 0 0 0 0 0 0 0 0 0 0 0 0 0 0 0 0 
0 0 6 0 0 0 0 0 0 0 0 0 0 0 0 0 0 0 0 0 0 0 0 0 0 0 0 0 
0 3 7 0 0 0 0 7 3 0 0 0 0 0 0 7 3 0 0 0 0 0 7 3 0 0 0 0 
0 7 3 0 0 0 0 3 7 0 0 0 0 0 0 3 7 0 0 0 0 0 3 7 0 0 0 0 
0 3 7 0 0 0 0 7 3 0 0 0 0 0 0 7 3 0 0 0 0 0 7 3 0 0 0 0 
0 7 3 0 0 0 0 3 7 0 0 0 0 0 0 3 7 0 0 0 0 0 3 7 0 0 0 0 
0 3 7 0 0 0 0 7 3 0 0 0 0 0 0 7 3 0 0 0 0 0 7 3 0 0 0 0 
0 7 3 0 0 0 0 3 7 0 0 0 0 0 0 3 7 0 0 0 0 0 3 7 0 0 0 0 
0 3 7 0 0 0 0 7 3 0 0 0 0 0 0 7 3 0 0 0 0 0 7 3 0 0 0 0 
0 7 3 0 0 0 0 3 7 0 0 0 0 0 0 3 7 0 0 0 0 0 3 7 0 0 0 0 
0 3 7 0 0 0 0 7 3 0 0 0 0 0 0 7 3 0 0 0 0 0 7 3 0 0 0 0 
0 7 3 0 0 0 0 3 7 0 0 0 0 0 0 3 7 0 0 0 0 0 3 7 0 0 0 0 
0 3 7 0 0 0 0 7 3 0 0 0 0 0 0 7 3 0 0 0 0 0 7 3 0 0 0 0 
0 7 3 0 0 0 0 3 7 0 0 0 0 0 0 3 7 0 0 0 0 0 3 7 0 0 0 0 
9 3 7 0 0 0 0 7 3 0 0 0 0 0 8 7 3 0 0 0 8 0 7 3 0 0 8 0 
1 1 1 1 1 1 1 1 1 1 1 1 1 1 1 1 1 1 1 1 1 1 1 1 1 1 1 1 
