28 16
0 4 4 4 4 7 0 0 0 0 0 0 0 0 0 0 0 0 0 0 0 0 7 0 7 9 1 6 
0 0 0 0 0 1 3 0 0 0 0 0 0 0 0 0 0 0 0 0 0 3 1 1 1 1 1 6 
0 0 0 0 0 1 3 0 0 0 0 0 0 0 0 0 0 0 0 0 3 5 1 1 1 1 1 6 
0 0 0 0 0 1 3 0 0 0 0 0 0 0 0 0 0 0 0 3 1 5 1 1 0 0 1 6 
0 0 0 0 0 1 3 0 0 0 0 0 0 0 0 0 0 0 3 1 1 5 1 1 7 0 1 6 
0 7 0 8 0 1 3 0 0 0 0 0 0 0 0 0 0 3 1 7 1 5 1 1 5 5 1 6 
1 1 1 1 0 0 1 3 0 0 0 0 0 0 0 0 3 1 0 3 1 5 1 1 0 0 1 6 
7 0 0 0 1 7 0 1 3 7 0 0 0 0 0 3 1 0 7 3 1 5 1 1 0 0 1 6 
1 1 1 3 0 1 0 0 1 1 3 0 0 0 3 1 1 1 1 3 1 5 1 1 0 0 1 6 
7 0 0 1 3 0 1 7 0 1 3 7 8 3 1 0 7 0 7 3 1 5 1 1 0 0 1 6 
1 1 3 0 1 3 0 1 0 0 1 1 3 1 1 1 1 1 1 3 1 5 1 1 0 0 1 6 
7 0 1 3 0 1 3 0 1 7 0 1 3 0 7 0 7 0 4 3 1 5 1 1 0 0 1 6 
1 3 0 1 3 0 1 3 0 1 0 1 3 1 1 1 1 1 0 3 1 5 1 1 5 5 1 6 
0 1 3 0 1 3 0 1 3 0 0 0 0 0 0 0 0 0 0 3 1 5 1 1 0 0 0 6 
0 0 3 0 0 3 0 0 3 0 0 0 0 0 8 0 0 0 0 3 0 0 0 0 0 0 0 6 
1 1 1 1 1 1 1 1 1 1 1 1 1 1 1 1 1 1 1 1 1 1 1 1 1 1 1 1 
