28 16
0 0 0 0 0 0 0 0 0 0 0 0 0 0 8 0 0 7 0 0 0 0 0 0 0 0 0 0 
0 0 0 0 0 0 0 0 0 7 0 0 1 1 1 1 1 1 3 1 0 7 0 0 0 0 0 0 
0 0 0 0 0 1 1 1 5 1 1 1 1 0 0 0 0 0 3 1 1 1 1 1 5 1 0 0 
0 0 0 0 0 1 0 0 0 0 0 0 1 0 0 0 0 0 3 1 0 0 0 0 0 1 0 0 
0 0 0 0 0 1 0 8 7 0 0 0 1 0 0 0 0 0 3 1 0 0 0 0 0 1 0 0 
0 1 1 1 1 1 1 1 1 0 7 0 1 7 0 0 1 3 1 1 1 1 1 7 7 1 0 0 
0 1 0 0 0 0 0 0 1 1 1 5 1 1 1 1 1 3 0 0 0 0 1 5 1 1 1 1 
0 1 0 0 0 0 0 0 1 0 0 0 0 0 7 0 1 3 0 8 7 0 0 0 0 4 0 1 
0 1 0 0 0 0 0 0 1 0 0 0 0 3 1 1 1 1 1 1 1 1 1 1 1 0 3 1 
0 1 0 0 0 7 0 7 1 0 0 0 0 3 1 0 0 0 0 0 0 0 0 0 7 0 3 1 
0 1 0 0 1 1 1 1 1 0 0 0 0 3 1 0 7 0 0 3 1 3 0 3 1 1 1 1 
0 1 1 1 1 0 0 0 1 0 7 1 3 1 1 1 1 0 0 3 1 1 1 5 1 0 0 0 
0 0 0 0 1 0 7 0 1 1 1 1 3 0 0 0 1 0 7 3 1 0 0 0 0 0 0 0 
0 0 0 0 1 1 1 1 1 0 0 1 3 0 0 0 1 1 1 5 1 0 0 0 0 0 0 0 
0 0 0 0 0 0 0 0 0 0 0 0 3 0 0 0 0 0 0 9 0 0 0 0 0 0 0 0 
2 1 2 1 2 1 2 1 2 1 2 1 2 1 2 1 2 1 2 1 2 1 2 1 2 1 2 1 
