28 16
0 4 4 4 4 4 4 4 4 1 0 0 0 0 0 0 0 0 0 0 8 0 0 0 0 0 0 0 
3 0 0 0 0 0 0 0 0 1 0 0 7 0 0 0 0 3 1 1 1 1 3 0 1 0 1 3 
3 0 5 5 5 5 5 5 0 1 1 1 1 1 3 2 0 3 2 0 0 0 3 0 1 0 1 3 
3 0 5 5 5 5 5 5 0 1 0 0 7 0 3 2 0 3 2 3 2 0 3 0 1 0 1 3 
3 0 5 5 5 5 5 5 0 1 3 1 1 1 1 2 0 3 2 3 2 0 3 0 1 0 1 3 
3 0 5 5 7 7 5 5 0 1 3 0 7 0 0 2 0 3 2 3 2 0 3 0 1 0 1 3 
3 0 5 5 5 5 5 5 0 1 1 1 1 1 3 2 0 3 2 3 2 0 3 0 1 0 1 3 
3 0 5 5 5 5 5 5 0 1 0 0 7 0 3 2 0 3 2 3 2 0 3 0 1 7 1 3 
3 0 0 0 0 0 0 0 8 1 3 1 1 1 1 2 0 3 2 3 2 0 3 0 1 1 5 3 
3 1 1 1 1 1 1 1 1 1 3 0 7 0 0 2 0 3 2 3 2 0 3 0 0 0 0 3 
3 1 1 1 1 1 1 1 1 1 1 1 1 1 3 2 1 1 2 3 2 1 1 1 1 1 1 3 
3 1 1 1 1 1 1 1 1 1 0 0 7 0 3 2 2 2 2 3 2 2 2 2 1 1 1 3 
3 1 1 7 7 1 1 1 1 1 3 1 1 1 1 2 0 7 0 6 0 7 0 2 7 1 1 3 
3 1 1 1 1 1 1 1 1 7 3 2 1 2 2 2 2 2 2 2 2 2 2 2 1 1 1 3 
3 2 2 2 2 2 2 2 2 2 2 0 0 0 0 0 0 0 7 0 0 8 7 0 0 0 0 3 
3 0 9 0 0 0 0 0 0 0 0 3 1 1 1 1 1 1 1 1 1 1 1 1 1 1 1 1 
