28 16
2 6 1 2 2 2 1 2 2 1 1 2 1 1 2 2 1 2 0 2 2 1 2 2 1 1 2 1 
2 3 6 6 6 6 6 2 6 2 1 2 2 1 6 2 6 6 6 6 6 6 2 2 1 1 1 1 
2 3 0 9 0 7 6 2 6 0 7 7 7 0 6 0 6 0 0 8 0 6 0 7 0 0 6 1 
2 3 2 1 2 1 6 2 6 1 2 1 1 2 3 1 3 2 1 1 1 3 1 1 1 1 6 1 
2 3 0 7 0 0 6 2 6 0 7 7 7 0 3 0 3 0 7 1 1 3 1 1 1 2 6 1 
2 3 2 1 2 6 6 2 6 0 1 1 1 0 3 0 3 0 2 2 7 3 7 1 1 7 6 1 
2 3 6 6 6 0 7 2 6 0 0 0 0 0 3 7 3 0 0 1 2 3 2 1 2 2 6 1 
2 3 0 0 6 1 1 2 6 0 0 7 0 0 3 2 3 0 0 7 0 3 4 4 4 4 6 1 
2 3 7 0 8 6 0 2 6 0 1 1 1 0 3 2 3 0 0 1 2 3 0 0 7 2 1 1 
2 3 1 1 1 1 3 2 6 0 0 1 0 0 3 7 3 0 0 1 0 3 0 1 1 7 6 1 
2 3 0 0 2 0 3 2 6 6 6 6 6 6 3 2 3 0 0 1 0 3 0 0 0 2 3 2 
2 3 0 0 2 0 3 4 4 4 4 4 4 4 4 4 3 7 8 1 0 3 2 7 7 7 3 1 
2 3 0 0 2 7 3 2 1 1 1 1 3 0 7 2 3 1 1 1 1 1 1 1 1 1 1 1 
2 3 0 0 2 1 3 2 0 0 0 1 1 1 1 1 2 1 2 4 4 4 4 4 4 4 3 1 
2 3 0 7 0 0 3 0 0 7 0 0 0 7 0 0 0 0 0 0 0 8 0 7 7 7 3 1 
2 1 1 1 1 1 1 2 1 2 2 2 2 2 2 2 2 2 2 2 2 1 2 2 2 2 3 1 
