28 16
0 0 0 0 0 0 0 0 0 0 0 0 0 0 0 0 0 0 0 0 0 0 6 0 0 0 0 0 
0 0 0 0 0 0 0 0 0 0 0 0 0 0 0 0 0 0 0 0 0 0 6 0 0 0 0 0 
8 0 0 0 0 0 0 0 7 1 7 0 0 0 0 0 0 0 0 0 0 0 6 1 7 0 0 0 
1 1 1 1 1 3 1 1 1 1 1 1 1 1 3 1 3 1 1 1 1 1 1 1 1 1 1 3 
7 0 0 0 1 3 0 7 0 0 0 0 0 0 3 1 3 0 0 0 0 1 0 0 0 0 0 3 
1 1 1 3 1 1 1 1 1 3 1 1 1 1 1 1 1 1 1 1 3 1 3 1 1 1 1 1 
7 0 0 3 0 0 0 0 0 3 0 0 8 0 0 0 0 0 0 0 3 1 3 0 0 0 0 7 
1 3 1 1 1 1 1 1 1 1 1 1 1 1 1 1 3 1 1 1 1 1 1 1 1 1 1 1 
7 3 1 1 7 0 0 1 0 0 0 0 0 0 7 1 3 0 0 0 0 8 0 1 7 0 0 0 
1 1 1 1 1 1 1 1 1 3 1 1 1 1 1 1 1 1 1 3 1 1 1 1 1 1 1 1 
1 1 3 0 0 0 0 0 8 3 1 1 1 7 0 1 1 0 0 3 0 0 1 1 0 0 7 1 
1 1 3 1 1 1 1 3 1 1 1 1 1 1 1 1 1 3 1 1 1 3 1 1 1 1 1 1 
7 0 3 1 1 1 1 3 1 0 7 1 1 1 1 1 7 3 1 1 1 3 0 0 0 0 1 1 
1 1 3 1 1 1 1 3 1 1 1 1 1 1 1 1 1 3 1 1 1 1 1 1 3 1 1 1 
1 1 3 0 0 0 1 3 0 0 0 0 0 1 0 9 0 3 0 0 1 0 0 0 3 0 0 7 
1 1 1 1 1 1 1 1 1 1 1 1 1 1 1 1 1 1 1 1 1 1 1 1 1 1 1 1 
