28 16
0 0 0 0 0 0 4 4 4 4 4 4 4 4 4 4 4 7 0 0 0 0 0 0 0 0 0 0 
2 2 2 2 2 2 0 0 0 1 1 0 0 0 0 0 1 2 2 2 2 2 2 1 3 0 0 0 
2 4 4 4 4 4 4 0 0 7 7 0 0 0 0 0 1 0 0 0 0 0 0 1 3 0 0 0 
2 3 0 0 0 0 0 0 1 1 1 5 0 0 0 0 1 0 8 0 0 0 7 1 3 0 0 0 
2 3 7 7 0 0 0 0 7 0 0 7 0 0 0 0 1 1 1 1 1 1 5 1 3 0 0 0 
2 2 2 2 3 0 7 0 1 5 1 1 0 0 0 0 0 0 0 0 0 0 8 3 3 0 0 0 
0 0 0 0 3 0 0 0 0 0 0 0 7 0 0 0 7 0 0 0 8 4 4 0 3 0 0 0 
0 0 0 0 3 0 0 0 0 0 1 2 2 2 2 2 2 2 2 2 1 4 4 0 3 0 0 0 
0 0 0 0 3 7 8 0 7 0 1 8 0 0 0 0 0 7 0 0 1 0 0 0 3 0 0 0 
0 0 0 0 3 1 1 1 1 3 1 1 1 1 1 1 5 1 1 1 1 0 0 0 3 0 0 0 
0 0 0 0 0 1 0 0 1 3 0 0 0 0 0 0 0 0 0 0 0 0 0 0 3 0 0 0 
0 0 0 0 0 1 0 0 1 3 0 0 0 0 0 0 0 0 0 0 0 0 0 0 3 0 0 0 
0 0 0 0 0 1 7 7 1 3 0 0 0 0 0 0 0 0 0 0 0 0 0 0 3 0 0 0 
0 0 0 0 0 1 1 5 1 3 0 0 0 0 0 0 0 0 0 0 0 0 0 0 3 0 0 0 
0 0 0 0 0 0 0 0 0 3 0 0 0 0 8 0 0 9 0 0 0 0 0 0 3 0 0 0 
1 1 1 2 2 2 2 2 1 1 1 2 2 2 2 1 1 1 2 2 2 2 1 1 1 2 2 2 
