28 16
0 0 0 0 0 0 0 0 0 0 0 0 0 3 3 4 4 4 4 3 3 3 3 3 1 1 1 1 
0 0 0 0 0 0 0 0 0 0 0 0 3 1 1 3 4 4 4 3 7 7 0 3 1 1 1 1 
0 0 0 0 0 0 0 0 0 0 0 3 1 1 1 1 3 0 0 0 3 3 7 3 0 3 0 3 
0 0 0 0 0 0 0 0 0 0 3 1 1 1 1 1 1 3 0 0 0 0 3 3 7 3 7 3 
0 0 0 0 0 0 0 0 0 0 3 1 1 1 1 1 1 3 0 0 0 0 0 3 3 3 3 3 
0 0 0 0 0 0 0 0 0 0 3 1 2 1 2 5 2 3 0 0 0 0 0 3 0 3 0 3 
0 0 0 0 0 0 0 0 0 0 3 7 2 1 2 5 7 3 0 0 0 0 0 3 0 3 0 3 
0 0 0 0 0 0 0 0 0 0 3 1 2 1 2 5 2 3 0 0 0 0 0 3 7 3 7 3 
7 4 4 4 4 4 4 4 4 4 3 1 2 1 2 5 2 3 0 0 0 0 0 3 3 3 3 3 
3 7 0 0 0 0 0 0 0 0 3 7 2 1 2 5 7 3 0 0 0 0 0 3 0 3 0 3 
1 3 7 0 0 0 0 0 0 0 3 1 2 1 2 5 2 3 0 0 0 0 0 3 0 3 0 3 
1 1 3 7 0 0 0 0 0 0 3 1 2 1 2 5 2 3 0 0 0 0 0 3 7 3 7 3 
1 1 1 3 7 0 0 0 0 0 3 7 1 1 1 5 7 3 0 0 0 0 0 3 3 3 3 3 
1 1 1 1 3 7 0 0 0 0 3 1 1 1 1 1 1 3 0 0 0 0 0 3 0 3 0 3 
1 1 1 1 1 3 7 0 0 3 2 1 0 1 2 0 1 2 3 0 0 0 9 3 7 3 7 3 
1 1 1 1 1 1 3 0 8 3 2 1 0 1 2 0 1 2 3 8 0 3 1 1 1 1 1 1 
