28 16
0 0 4 4 4 0 0 0 0 0 0 7 0 0 7 0 0 0 0 4 4 4 0 0 2 0 1 3 
1 1 0 0 1 3 0 0 0 0 3 1 1 1 1 3 0 0 3 8 0 0 1 1 2 0 0 3 
0 1 1 0 1 3 0 0 0 3 1 1 1 1 1 1 1 1 1 1 3 0 1 1 2 0 1 3 
1 1 0 0 1 3 1 1 1 1 1 7 1 1 7 1 1 1 1 1 3 0 1 7 2 1 1 3 
7 1 1 7 1 3 0 0 0 0 0 8 0 0 0 0 0 0 0 0 3 0 0 0 0 0 1 3 
1 1 1 1 1 1 1 1 1 1 1 1 1 1 1 1 1 5 1 1 1 1 1 1 1 1 1 3 
0 0 0 7 0 8 0 0 0 7 0 0 0 0 0 0 0 0 0 0 9 0 0 0 8 0 0 3 
2 2 2 2 2 2 2 2 2 2 2 2 2 2 2 2 3 1 1 1 1 1 1 1 1 1 1 1 
0 4 4 4 4 4 4 4 4 4 4 4 4 4 0 2 3 0 0 0 0 0 0 0 0 0 0 0 
3 0 0 0 0 0 0 4 0 0 0 0 0 0 3 2 3 4 4 4 4 4 4 4 4 4 4 0 
3 0 0 0 0 0 4 0 4 0 0 0 0 0 3 2 1 1 0 1 1 0 1 1 0 1 1 3 
3 0 0 0 0 4 0 1 0 4 0 0 0 0 3 2 2 2 2 2 2 2 2 2 2 2 2 3 
3 0 0 0 4 0 1 1 1 0 4 0 0 0 3 4 4 4 4 4 4 4 4 4 4 4 4 3 
3 0 0 4 0 1 1 1 1 1 0 4 0 0 3 5 1 5 1 5 1 5 1 5 1 5 1 5 
3 0 4 0 1 1 7 7 7 1 1 0 4 0 3 2 0 0 0 0 0 0 0 0 0 0 0 0 
3 4 0 1 1 1 1 1 1 1 1 1 0 4 3 2 0 0 0 0 0 0 0 0 8 0 0 0 
