28 16
0 0 6 0 0 0 0 0 0 0 0 0 0 0 0 0 0 0 0 0 0 0 0 0 0 0 0 0 
0 0 6 0 0 0 0 0 0 0 0 0 0 0 0 0 0 0 0 0 0 0 0 0 0 0 0 0 
0 0 6 0 0 0 0 0 0 4 4 4 4 4 0 0 0 0 0 0 0 0 4 4 4 4 4 3 
0 8 3 0 0 0 0 4 0 0 0 0 0 0 3 0 0 4 4 0 8 3 0 0 0 0 0 3 
5 1 3 4 4 4 3 0 1 5 1 1 0 0 3 1 1 0 0 1 1 3 0 1 1 5 1 1 
5 1 0 0 0 0 3 1 1 5 1 1 1 0 3 1 1 0 0 1 1 3 0 1 1 5 1 0 
5 1 0 0 0 0 3 1 1 8 4 0 0 0 3 1 1 0 0 1 1 3 0 1 1 0 0 0 
5 1 0 0 0 0 3 1 1 3 0 1 1 0 3 1 1 0 0 1 1 3 4 0 1 0 0 0 
5 1 0 7 0 0 3 1 1 3 7 1 1 0 3 1 1 7 0 1 1 7 3 5 5 7 9 0 
5 0 4 4 3 4 3 1 1 3 0 1 1 0 3 1 1 0 0 1 1 0 3 1 1 1 1 0 
1 1 0 3 3 0 0 1 1 3 0 0 1 0 3 1 1 0 0 1 1 0 3 1 1 1 1 0 
1 1 3 3 0 0 0 1 1 3 0 5 0 4 3 1 1 0 0 1 1 0 3 1 1 0 0 0 
1 1 3 0 0 0 0 1 1 3 0 1 1 0 0 1 1 0 0 1 1 0 3 1 1 0 0 0 
1 1 3 0 7 4 4 1 1 3 0 0 7 0 0 0 1 0 7 1 0 0 3 0 0 0 7 0 
1 1 1 1 1 3 0 1 1 1 1 1 1 3 0 0 1 1 5 1 0 0 3 1 1 1 1 3 
1 1 1 1 1 3 0 7 1 1 1 1 0 3 0 0 7 1 5 7 0 0 3 1 1 1 1 1 
