28 16
7 0 0 1 1 1 1 1 1 1 1 1 1 1 1 6 1 1 1 1 1 1 1 1 1 1 1 1 
3 1 4 4 4 0 0 0 0 4 0 0 0 7 1 6 1 0 0 0 0 0 0 0 0 0 0 1 
3 1 7 1 0 1 1 1 1 0 1 1 1 1 1 6 1 3 1 1 1 3 1 1 1 1 3 1 
3 1 7 1 0 1 0 0 1 0 0 0 7 0 1 6 1 3 1 1 1 3 1 1 1 1 3 1 
3 1 7 1 0 1 7 7 1 1 1 1 1 1 1 6 1 3 0 0 1 3 0 8 7 1 3 1 
3 1 7 1 0 1 1 1 1 1 1 1 1 1 1 6 1 1 1 3 1 3 1 1 1 1 3 1 
3 1 7 1 0 0 7 0 0 0 0 8 0 0 0 6 0 0 1 3 1 3 1 1 1 1 3 1 
3 1 7 1 1 1 1 1 3 1 1 1 1 7 0 6 0 7 1 3 1 3 0 0 0 0 3 1 
3 1 7 1 0 0 0 0 3 0 0 0 1 1 1 1 1 1 1 3 1 1 1 1 1 1 3 1 
3 1 7 1 3 1 1 1 7 1 1 3 0 0 7 0 0 0 1 3 0 0 0 7 0 1 3 1 
3 1 7 1 3 1 0 7 0 0 1 1 1 1 1 1 1 3 1 1 1 1 1 1 1 1 3 1 
3 1 7 1 3 0 3 1 1 3 8 7 0 0 0 0 1 3 0 0 0 0 7 0 0 1 3 1 
3 1 7 1 1 1 1 1 1 1 1 1 1 1 1 3 1 1 1 1 1 1 1 1 3 1 3 1 
3 1 7 1 7 0 0 1 0 7 0 1 0 7 0 3 7 0 1 0 0 0 7 0 3 1 3 1 
3 1 5 1 3 1 3 1 3 1 3 1 3 1 1 1 1 1 1 3 1 1 1 1 1 1 3 1 
3 0 7 0 3 1 3 7 3 1 3 7 3 1 9 0 0 7 0 3 0 0 7 0 0 0 3 1 
